The Vault
An Interactive Fiction by Brandon Cooper
Release 1 / Serial number 150416 / Inform 7 build 6L38 (I6/v6.33 lib 6/12N) SD

Main Tunnel Entrance
You enter a dusty interior, dimly lit by narrow sunshafts entering through the vault door. Next to the door lies a control panel.

You hear a crackling sound from an unseen speaker above: "Get out! You are unwelcome here. Leave me to my experiments.".

>examine vault door
You see nothing special about the vault door.

>take vault door
That's fixed in place.

* * *

The Vault
An Interactive Fiction by Brandon Cooper
Release 1 / Serial number 150416 / Inform 7 build 6L38 (I6/v6.33 lib 6/12N) SD

Main Tunnel Entrance
You enter a dusty interior, dimly lit by narrow sunshafts entering through the vault door. Next to the door lies a control panel.

You hear a crackling sound from an unseen speaker above: "Get out! You are unwelcome here. Leave me to my experiments.".

>examine vault
You see nothing special about the vault door.

* * *

The Vault
An Interactive Fiction by Brandon Cooper
Release 1 / Serial number 150416 / Inform 7 build 6L38 (I6/v6.33 lib 6/12N) SD

Main Tunnel Entrance
You enter a dusty interior, dimly lit by narrow sunshafts entering through the vault door. Next to the door lies a control panel.

You hear a crackling sound from an unseen speaker above: "Get out! You are unwelcome here. Leave me to my experiments.".

>h
You're in good health

>health
That's not a verb I recognise.

* * *

>kj
That's not a verb I recognise.

>j
That's not a verb I recognise.

* * *

The Vault
An Interactive Fiction by Brandon Cooper
Release 1 / Serial number 150416 / Inform 7 build 6L38 (I6/v6.33 lib 6/12N) SD

Main Tunnel Entrance
You enter a dusty interior, dimly lit by narrow sunshafts entering through the vault door. Next to the door lies a control panel.

You hear a crackling sound from an unseen speaker above: "Get out! You are unwelcome here. Leave me to my experiments.".

>health
You're in good health.

>h
That's not a verb I recognise.

* * *

>health
You're in good health.

>Health
That's not a verb I recognise.

* * *

>health
You're in good health.

>health
You are beginning to feel nauseous from the health.

>health
You feel tired and dizzy. You should probably see a doctor

>health
Your limbs shake as you stumble along. You're positively glowing.

* * *

The Vault
An Interactive Fiction by Brandon Cooper
Release 1 / Serial number 150416 / Inform 7 build 6L38 (I6/v6.33 lib 6/12N) SD

Main Tunnel Entrance
You enter a dusty interior, dimly lit by narrow sunshafts entering through the vault door. Next to the door lies a control panel.

You hear a crackling sound from an unseen speaker above: "Get out! You are unwelcome here. Leave me to my experiments.".

>examine self
As good-looking as ever.

>examine self
As good-looking as ever.

>wear
(the space suit)
You're already wearing that!

>check self
As good-looking as ever.

* * *

The Vault
An Interactive Fiction by Brandon Cooper
Release 1 / Serial number 150416 / Inform 7 build 6L38 (I6/v6.33 lib 6/12N) SD

Main Tunnel Entrance
You enter a dusty interior, dimly lit by narrow sunshafts entering through the vault door. Next to the door lies a control panel.

You hear a crackling sound from an unseen speaker above: "Get out! You are unwelcome here. Leave me to my experiments.".

>examine key
You see nothing special about the key card.

* * *

The Vault
An Interactive Fiction by Brandon Cooper
Release 1 / Serial number 150416 / Inform 7 build 6L38 (I6/v6.33 lib 6/12N) SD

Main Tunnel Entrance
You enter a dusty interior, dimly lit by narrow sunshafts entering through the vault door. Next to the door lies a control panel.

You hear a crackling sound from an unseen speaker above: "Get out! You are unwelcome here. Leave me to my experiments.".

>TREE
compass (576119) 
  the north
  the northeast
  the northwest
  the south
  the southeast
  the southwest
  the east
  the west
  the up
  the down
  the inside
  the outside
(darkness object) (576151) 
(Inform Parser) (576183) 
(Inform Library) (576215) 
(property_numberspace_forcer) (576247) 
(ValuePropertyHolder_42) (576311) 
(ValuePropertyHolder_46) (576343) 
Main Tunnel Entrance (577303) 
  yourself
  a vault door
  a rusty control panel
    a key card
Antechamber (577431) 
Leader's Office (577463) 
Vault (577495)

* * *

The Vault
An Interactive Fiction by Brandon Cooper
Release 1 / Serial number 150416 / Inform 7 build 6L38 (I6/v6.33 lib 6/12N) SD

Main Tunnel Entrance
You enter a dusty interior, dimly lit by narrow sunshafts entering through the vault door. Next to the door lies a control panel.

You hear a crackling sound from an unseen speaker above: "Get out! You are unwelcome here. Leave me to my experiments.".

>examine door
A massive, weathered lead door. It may have withstood the blast, but it has definitely seen better days.

* * *

The Vault
An Interactive Fiction by Brandon Cooper
Release 1 / Serial number 150416 / Inform 7 build 6L38 (I6/v6.33 lib 6/12N) SD

Main Tunnel Entrance
You enter a dusty interior, dimly lit by narrow sunshafts entering through the vault door. Next to the door lies a control panel.

You hear a crackling sound from an unseen speaker above: "Get out! You are unwelcome here. Leave me to my experiments.".

>examine pane
You can't see any such thing.

>examine panel
A rusty control panel probably used to open the vault door. It doesn't seem to be working now. On top of the panel lies a key card.

>take card
You can't see any such thing.

>take key
You can't see any such thing.

>take key card
You can't see any such thing.

>examine key card
You can't see any such thing.

>examine panel
A rusty control panel probably used to open the vault door. It doesn't seem to be working now. On top of the panel lies a key card.

* * *

The Vault
An Interactive Fiction by Brandon Cooper
Release 1 / Serial number 150416 / Inform 7 build 6L38 (I6/v6.33 lib 6/12N) SD

Main Tunnel Entrance
You enter a dusty interior, dimly lit by narrow sunshafts entering through the vault door. Next to the door lies a control panel.

You hear a crackling sound from an unseen speaker above: "Get out! You are unwelcome here. Leave me to my experiments.".

>examine card key
You can't see any such thing.

>examine key car
You can't see any such thing.

>examine key card
You can't see any such thing.

* * *

The Vault
An Interactive Fiction by Brandon Cooper
Release 1 / Serial number 150416 / Inform 7 build 6L38 (I6/v6.33 lib 6/12N) SD

Main Tunnel Entrance
You enter a dusty interior, dimly lit by narrow sunshafts entering through the vault door. Next to the door lies a control panel.

You hear a crackling sound from an unseen speaker above: "Get out! You are unwelcome here. Leave me to my experiments.".

>look
Main Tunnel Entrance
You enter a dusty interior, dimly lit by narrow sunshafts entering through the vault door. Next to the door lies a control panel.

>n
You can't go that way.

>e
Antechamber

>w
Main Tunnel Entrance
You enter a dusty interior, dimly lit by narrow sunshafts entering through the vault door. Next to the door lies a control panel.